NO  ./textures/debug_n.png

SO           ./textures/debug_s.png
F 35, 33, 64



WE                                 ./textures/debug_w.png
EA                   ./textures/debug_e.png

C 64, 33, 35

11111111111111111111111111111111
100000000000000S0000000000000001
10001111100111111111100111110001
10001000000000000000000000010001     11111111
10000000101010101010101000000001     10010001
10000000000000000000000000000001     10000001
100000110001111111111100110000011111110000101
1000001000000000000000000100000D0000000010001
1000000000000000000000000000000D0000000000001
100000000000D11111110000000000011111110010001
1000001000001      1000001000001     10000101
1000001000001      1000001000001     10000001
10000000000011111111000000000001     11100111
10000000000000000000000000000001       1001
10000010000000000000000001000001       1001
10000011000111111111110011000001      1001
10000000000000000000000000000001       1001
10000000101010101010101000000001       1001
10001000000000000000000000010001       1001
10001111100111111111100111110001       1001
10000000000000000000000000000001       1001
11111111111111DD1111111111111111       1001
             1001                      1001
             1001                      1001
             1001                      1001
             100111111111111111111111111001
             100000000000000000000000000001
             111111111111111111111111111111
