NO textures/CONSOLE_1B.PNG
SO textures/BRICK_1A.PNG
WE textures/SUPPORT_4A.PNG
EA textures/TECH_1C.PNG



F 50, 50, 50
C 0, 50, 100

11111111111111111111111111111111
100000000000000N0000000000000001
100011111001111111D1100111110001
10001000000000000000000000010001     11111111
10000000101010101010101000000001     10010001
10000000000000000000000000000001     10000001
100000110001111111111100110000011111110000101
1000001000000000000000000100000D0000000010001
1000000000000000000000000000000D0000000000001
100000000000111DD1110000000000011111110010001
10000010000010000001000001000001     10000101
10000010000010000001000001000001     10000001
10000000000011111111000000000001     11100111
10000000000000000000000000000001       1001
10000010000000000000000001000001       1001
10000011000111111111110011000001      1001
10000000000000000000000000000001       1001
10000000101010101010101000000001       1001
10001000000000000000000000010001       1001
10001111100111111111100111110001       1001
10000000000000000000000000000001       1001
11111111111111DD1111111111111111       1001
             1001                      1001
             1001                      1001
             1001                      1001
             100111111111111111111111111001
             100000000000000000000000000001
             111111111111111111111111111111
